################
#..............#
#..............#
#.........@....#
#..............#
#....@.........#
#..............#
#..............#
################