################
#...#......#...#
#...#......#.@.#
#..............#
#..............#
#..............#
#.@.#......#...#
#...#......#...#
################