################
#....##........#
##..........@..#
#.......#......#
#..........#...#
#...#...#......#
##.............#
#.....#.......##
#..@.......#...#
#......#.......#
################