################
#.....#........#
##..........@..#
#.......#......#
#..............#
#....#.........#
##.............#
#..............#
#..........#...#
#.@............#
#.............##
################