################
#......###.....#
#........#...@.#
##............##
#....#....#....#
#.@............#
#......#.......#
#....#.........#
################